111111111111111111111111111111111111111111111111111111111111111111111111111111111111111111
1                                                                                        1
1                                                                                        1
1                                                                                        1
1                                                                                        1
1                                                                                        1
1                                                                                        1
1                                                                                        1
1                                                                                        1
1                                                                                        1
1                                                                                        1
1                                                                                        1
1                                                                                        1
1                     11111                                                              1
1                     12221                                                              1
1                     12221                                                              1
1                     12221                                                              1
1                     11011                                                              1
1                       0                                                                1
1                       0                                                                1
1                       0                                                                1
1                       0                                                                1
1                       0                                                                1
1                        0                                                               1
1                        0                                                               1
1                        0                                                               1
1                        00                                                              1
1                         0                                                              1
1                         000                                                            1
1                         00                                                             1
1                         0                                                              1
1                                                                                        1
1                                                                                        1
1                                                                                        1
1                                                                                        1
1                                                                                        1
1                                                                                        1
1                                                                                        1
1                                                                                        1
1                                                                                        1
1                                                                                        1
1                                                                                        1
1                                                                                        1
1                                                                                        1
1                                                                                        1
1                                                                                        1
1                                                                                        1
1                                                                                        1
1                                                                                        1
1                                                                                        1
111111111111111111111111111111111111111111111111111111111111111111111111111111111111111111